000000000000000000000000000000000000000000
011111111111111111111111111111111111111110
011111111111111111111111111111111111111110
011111111111111111111111111211211111111110
011111111111111111111111111111111111111110
011111111111111111111111211121111111111110
011111111111111111111111112111112111111110
011111111111111111111111111111111111111110
011111111111111111111111111111111111111110
011111111111111111111111111111111111111110
011111111111111111111111111111111111111110
011111111111111111111111111111111111111110
011111111111111111111111111111111111111110
011111111111111111111111111111111111111110
011111111111111111111111111111111111111110
011111111111111111111111111111111111111110
011111111111111111111111111111111111111110
000000000000000000000000000000000000000000