22222222222222222222222222222222222222222222222222222222222222222
21111111111111431111111114441311111111111311111311111311111111412
21111111141111111111111111113111113111111311111113111111311141112
21111111111111114411131111111111111111111113431111111441111111112
21111111111411111411411111111111111111111111111111131111131141412
21311111111111311111113111113131311111111313114111111111111141112
21111141111114111311111111111111111311131113111414111111111111132
21111111111111131111111111141113141111311111111131111111311111112
23111111441111111141131111111111111113111111111111111141111111312
23131311111111113131111111111111111111111113111411111111111411112
21111334411131111111111411131111111111111141111111111111111111112
21111111111114111131111131133111111114111311111311111111111111112
21111111111113111111111111413114131111111111111111111111141111142
21111114111111111111431111111111111111111111311131141411111411312
21114111131114111113111111113113114411111114114111113111314111112
21111141111414111111111111311111111111111111141111111111311111112
21111111111111111111111111311111111111111111111111111131111111112
21111111313111111111111111113111111111311311111111411141311111112
21411111111111111111111113111311111111111114111111111111111113112
21114331111111114131111313141111111311111111111111111111311111142
21111111111411114111111111311111113111111111111111111111111113112
24111111111311111113111111111114141111113111111131111111111114112
21111111111111111111111111111113111111111111411114111111141111112
21111134141111111114414111141111111341111111141111111133111111112
21114111141111114111311141111111111111111111113111111144111111112
21114111411111111111111111113111111113314111111141111111411111412
21111141131111111111111111114111111131111143111431113111111111312
21131111111311311111411111111111111134111111413114114111411141112
21113311113111111131141311111111111111111331131111141111113341112
21111111111111113111111111113131131111111111131111111113111111112
23111313413111111111111111111144111111111131131111131111111111112
21111111311111111111131114111111111111141111313111113111111131112
21411111134111141111111111311111111411111311111311111111411111412
21111111111111111111411113111311111141411111433111111113411111112
21113111111111111111114111111111111111114111111111111111111113112
21111111111113111331113411311111111111111111111341311111111113112
21131411111111111131131111111111111111141111114311111141141111142
21111111341133131131411141411111111114311111111111111111111111112
21111111111111111111111111111111111411311111411111113111311111112
21111111131111111111111111144111311114111111111111114111111111312
21311111111111111111111141131111111111111111141111111111111111112
21111111111111413114113111113114111111111431111111111411111113112
21111114111111143111111144111111111111111144114111111111411131112
21111111111141111111111111141111111111111111111411113111411111112
21111114111111311114113113111141111111111411111111114111111111132
22222222222222222222222222222222222222222222222222222222222222222
